15 x 30
******************************
*  R            **        *  *
*      *         *   *       *
*             R    *    R    *
*    *   **       **       * *
*   R                        *
*            *           *   *
*       **               *   *
*  *     *        *    **    *
*       *    **              *
*                    H       *
*    *   R   *    ***    *   *
*      ***   *           *   *
*     *            *         *
******************************