15 x 30
*********OO*******************
*  R            **        *  *
*      *         *   *       *
*             R    *    R    *
*    *   **       **       * *
*   R                        =
*            *           *   *
*       **               *   *
*  *     *        *    **    *
*       *    **              *
*                    H       *
*    *   R   *    ***    *   *
O      ***   *           *   *
*     *            *         *
******************************